1111111111
1000100001
11001C0001
100P000011
1000000001
1000000001
10000C0001
1000000011
1000000E01
1111111111
