111111
1P0101
110C01
1E0001
111111