1111111111111111111111111111111111
1E00000000000001C10000C00000000001
1100010100100000E01001000000010101
1100100101010100100100000001010011
1P0001000C00C000000000001C10000001
1111111111111111111111111111111111