1111111111111111111111111
1P00000000001000000000001
1111011111010101111101111
1000010001010101000000001
1011110101011101111111011
1000000101000000000000011
1111110101111110111111011
1000000000C000001000000E1
1011111111101111111111011
10000000001000C0000000011
1111111111111111111111111
